subject,condition,amplitude,tmax,rt,n_targets,n_hit,n_miss,n_distractors,n_fa,n_cr,isi_power,oddball_power,powerSum
001,acc_oddball,0.914487906107733,1233.33333333333,0.562967899408088,138,90,48,662,3,659,5.66215580573317,0.801576508739021,6.46373231447219
002,acc_oddball,0.642442562523471,1300,0,137,131,6,663,6,657,-1.21669075466724,5.00263161585697,3.78594086118974
003,acc_oddball,0.499926020854735,1300,0.58229570944992,142,122,20,658,13,645,-1.30507967787568,0.626637477028827,-0.678442200846854
005,acc_oddball,1.2235619819428,1800,0.497179164908205,145,90,55,655,8,647,2.05285594556469,2.82904868889549,4.88190463446018
008,acc_oddball,0.925108551331037,1300,0.47228018535329,146,133,13,654,2,652,3.84947848209552,2.01384236510383,5.86332084719935
009,acc_oddball,1.12171599231176,1833.33333333333,0.611342986231466,140,95,45,660,9,651,2.24315947400485,1.17997874847927,3.42313822248412
010,acc_oddball,0.352381807225051,1833.33333333333,0.528486125493662,145,81,64,655,7,648,-0.538226899892811,2.79562733253073,2.25740043263792
011,acc_oddball,0.339967346174784,966.666666666667,0.43187144770616,140,119,21,660,3,657,4.32512399004087,1.11849440367795,5.44361839371883
012,acc_oddball,0.916527452660682,1066.66666666667,0.394075941127895,143,133,10,657,2,655,5.75991525740491,4.79183853798565,10.5517537953906
013,acc_oddball,0.434974143923662,1733.33333333333,0.703034835260041,139,50,89,661,22,639,-1.55332560450442,0.608077606551119,-0.945247997953305
014,acc_oddball,0.476360255226903,1766.66666666667,0.558223910675617,150,74,76,650,26,624,0.379454556161879,-1.31577608100483,-0.936321524842948
015,acc_oddball,1.00258462399339,1533.33333333333,0.560221432718796,140,96,44,660,11,649,3.41208108395238,2.50231478413126,5.91439586808364
016,acc_oddball,1.4071175377676,966.666666666667,0.547473565126232,146,95,51,654,18,636,0.668158605190814,2.90734760288344,3.57550620807425
017,acc_oddball,1.00809825861164,1066.66666666667,0.513609760801739,152,101,51,648,6,642,5.2442570211358,3.65485730531612,8.89911432645192
018,acc_oddball,0.793181599820206,1200,0.593204064079946,143,100,43,657,8,649,4.5489278491308,1.64007222131081,6.18900007044161
021,acc_oddball,0.814438867973071,1133.33333333333,0.550490080520696,142,108,34,658,9,649,1.87589777795294,1.60333775883703,3.47923553678997
022,acc_oddball,0.119341574420779,1366.66666666667,0.503534872456716,144,81,63,656,11,645,1.40724677071131,2.07708129074341,3.48432806145472
023,acc_oddball,1.12598161074762,1066.66666666667,0.461842054403853,146,125,21,654,3,651,2.52716489250054,3.65037441890952,6.17753931141006
027,acc_oddball,1.24798155395241,1700,0.538353951290594,146,86,60,654,12,642,2.41689807176629,3.06521383642557,5.48211190819186
028,acc_oddball,0.189163032265287,1266.66666666667,0.61596213859555,144,57,87,656,32,624,1.25525053414501,2.04754902611386,3.30279956025887
029,acc_oddball,0.750208767138094,1700,0.604774614767839,146,97,49,654,16,638,-0.527234625505094,2.0514680223458,1.52423339684071
030,acc_oddball,1.23180363482162,1766.66666666667,0.527870719360587,145,123,22,655,10,645,1.78121274730322,3.83200080256524,5.61321354986846
031,acc_oddball,0.687346069435403,1666.66666666667,0.503414875308942,143,126,17,657,12,645,5.34186579562022,0.750582435833587,6.09244823145381
032,acc_oddball,0.427005716073183,1066.66666666667,0.600984889879243,145,86,59,655,56,599,1.25350772132933,2.07211916453685,3.32562688586618
034,acc_oddball,0.482463793897873,2400,0.509735339657009,135,78,57,665,4,661,3.5457691369595,-0.428975929219573,3.11679320773992
036,acc_oddball,0.539508868314377,1433.33333333333,0.513680463050851,140,61,79,660,25,635,2.25470375647835,2.39941217212466,4.654115928603
037,acc_oddball,0.691511247522531,1166.66666666667,0.498866799483949,141,72,69,659,7,652,0.552700892447421,-0.512575383948608,0.0401255084988126
038,acc_oddball,0.313657994755119,1633.33333333333,0.522690464549907,148,107,41,652,1,651,1.23465232005157,3.15069185575071,4.38534417580228
039,acc_oddball,0.429461951653082,1033.33333333333,0.471121705877984,145,123,22,655,43,612,2.79471713430922,0.614659203059256,3.40937633736847
053,acc_oddball,0.921678188349547,1700,0.509058358226163,142,84,58,658,7,651,3.23819200508812,0.393284134559916,3.63147613964803
054,acc_oddball,0.610583028748938,900,0.431372952885004,150,138,12,650,2,648,1.25479903705381,2.05953936546884,3.31433840252266
055,acc_oddball,1.09551624310181,1166.66666666667,0.497616750378051,141,124,17,659,64,595,2.63268345170178,2.93386341769574,5.56654686939752
056,acc_oddball,0.549691062092932,1066.66666666667,0.479524329992138,141,108,33,659,11,648,0.177254073116343,0.567882167877152,0.745136240993495
057,acc_oddball,0.606307150301259,1066.66666666667,0.527480709778266,141,108,33,659,13,646,3.26830194401335,2.49310803990625,5.7614099839196
058,acc_oddball,0.795940642762977,1433.33333333333,0.577342178141628,149,99,50,651,25,626,0.137786772686558,0.279713384168982,0.41750015685554
059,acc_oddball,0.706759841518819,2100,0.661444202696381,146,56,90,654,16,638,1.08520595596787,1.41612429307607,2.50133024904394
060,acc_oddball,1.43764588652511,1566.66666666667,0.497463323371007,141,105,36,659,8,651,5.41816960694022,5.02003820493349,10.4382078118737
061,acc_oddball,1.08570611065712,1466.66666666667,0.551656813202365,147,95,52,653,18,635,3.57174239226416,1.93185862167865,5.50360101394282
063,acc_oddball,1.55555261077349,1833.33333333333,0.58730658062708,145,86,59,655,0,655,3.50880959229508,5.0150498163747,8.52385940866978
064,acc_oddball,0.45217925700044,1100,0.480484786569529,138,90,48,662,35,627,1.03300138865522,1.70690991713356,2.73991130578878
065,acc_oddball,0.566784304082495,1000,0.407144236291267,146,141,5,654,1,653,2.62662849924977,0.555396979347317,3.18202547859708
067,acc_oddball,1.08545010089259,1366.66666666667,0.501427399558856,143,108,35,657,5,652,4.83873283398617,5.22452352675484,10.063256360741
068,acc_oddball,1.05840800571129,1166.66666666667,0.542944323352363,147,105,42,653,2,651,5.00182424579773,4.00064357246787,9.0024678182656
069,acc_oddball,0.744861264139934,1466.66666666667,0.431814958358154,148,120,28,652,33,619,5.10961578841621,0.137520300538864,5.24713608895507
070,acc_oddball,0.987247133264149,1833.33333333333,0.467651202145805,143,95,48,657,15,642,3.94955093751502,-0.854991007494328,3.09455993002069
071,acc_oddball,0.721510588226871,1300,0.477328078542766,145,103,42,655,44,611,1.26294944433187,1.59755674261892,2.86050618695079
072,acc_oddball,0.145623990992337,900,0.505730320202842,140,84,56,660,22,638,1.51289280602381,-0.364188236581963,1.14870456944184
073,acc_oddball,1.06352895273199,1466.66666666667,0.667411033644688,147,48,99,653,10,643,-0.0352942608444444,3.66212990686959,3.62683564602514
075,acc_oddball,0.52206689030211,933.333333333333,0.461755115199199,142,106,36,658,40,618,0.376555534847306,3.29925792823071,3.67581346307802
077,acc_oddball,0.412502713731371,1033.33333333333,0.519643231383834,148,79,69,652,21,631,-0.213694555570801,0.406816111228503,0.193121555657703
078,acc_oddball,0.956390432146806,1700,0.510430424167391,143,85,58,657,6,651,4.49787595585635,3.27331132752669,7.77118728338303
079,acc_oddball,0.91745578378957,1000,0.462288364866569,145,127,18,655,3,652,4.58480367451024,4.60031675157833,9.18512042608857
080,acc_oddball,0.316128400857788,1933.33333333333,0.571399441315757,149,52,97,651,131,520,0.956929200713414,-0.812701174038777,0.144228026674637
081,acc_oddball,0.415181487936208,1366.66666666667,0.649855303797477,146,143,3,654,11,643,1.25574535479339,1.82533206085803,3.08107741565142
082,acc_oddball,0.788213357494731,1933.33333333333,0.56671739976709,138,105,33,662,58,604,4.7145645628092,2.14130940462732,6.85587396743652
083,acc_oddball,0.673031093501576,1600,0.475027546407391,137,106,31,663,10,653,4.54632458406348,0.611847975693186,5.15817255975667
084,acc_oddball,0.180416217337428,1533.33333333333,0.609384293736118,143,41,102,657,45,612,1.25555673241278,2.05185169244645,3.30740842485922
086,acc_oddball,0.421610881348692,766.666666666667,0.367304868124716,146,138,8,654,21,633,2.66217509850793,2.68312254886604,5.34529764737397
087,acc_oddball,0.174442505224168,900,0.280071628762862,142,142,0,658,548,110,4.44985435368166,2.20487838335925,6.65473273704091
088,acc_oddball,1.06800158122747,1266.66666666667,0.337041257491211,142,142,0,658,7,651,2.61816212350328,1.86795284029657,4.48611496379985
089,acc_oddball,0.84902905890974,1633.33333333333,0.498369125310481,134,56,78,666,13,653,-0.874817872093457,0.0782681057083153,-0.796549766385141
090,acc_oddball,1.30092963179261,1300,0.614376304774649,144,63,81,656,5,651,2.60189758054638,2.68115190750947,5.28304948805584
092,acc_oddball,0.66889520427992,1033.33333333333,0.394093996752053,145,130,15,655,1,654,-0.872124112031237,-0.714973554011881,-1.58709766604312
093,acc_oddball,0.676597663748101,1566.66666666667,0.453651951893384,139,74,65,661,2,659,0.784122632232571,3.46286249028253,4.2469851225151
094,acc_oddball,1.84039978001295,1766.66666666667,0.506288494694593,144,92,52,656,12,644,0.231663632679181,5.71591709765526,5.94758073033444
095,acc_oddball,0.415699615939485,1000,0.574290100477058,145,87,58,655,36,619,0.653018291442756,0.625661668701192,1.27867996014395
096,acc_oddball,0.956889630689848,1600,0.428939370092537,139,105,34,661,3,658,2.65158764173052,3.00605910605768,5.6576467477882
097,acc_oddball,0.51576422017289,1400,0.539360222628836,150,109,41,650,6,644,4.48849362648045,1.14690974057349,5.63540336705394
100,acc_oddball,0.34472733914348,-266.666666666667,0.495311823973229,143,101,42,657,21,636,3.68720567612967,-0.609993501719291,3.07721217441038
101,acc_oddball,0.739009721232583,2100,0.558976587427177,144,85,59,656,17,639,3.37816246550339,1.49778931699352,4.87595178249691
102,acc_oddball,0.650138824740665,1666.66666666667,0.518015815866244,140,119,21,660,10,650,1.75225625001837,3.25080069511659,5.00305694513495
106,acc_oddball,0.240879063012497,1200,0.407158206342285,147,118,29,653,265,388,1.50527987092354,0.210080204893992,1.71536007581753
001,omission,0.843061493266126,1900,0.562967899408088,138,90,48,662,3,659,5.66215580573317,0.801576508739021,6.46373231447219
002,omission,0.58669384660872,933.333333333333,0,137,131,6,663,6,657,-1.21669075466724,5.00263161585697,3.78594086118974
003,omission,0.0690744213927708,-766.666666666667,0.58229570944992,142,122,20,658,13,645,-1.30507967787568,0.626637477028827,-0.678442200846854
005,omission,0.584485305333557,2900,0.497179164908205,145,90,55,655,8,647,2.05285594556469,2.82904868889549,4.88190463446018
008,omission,0.612886717036095,1466.66666666667,0.47228018535329,146,133,13,654,2,652,3.84947848209552,2.01384236510383,5.86332084719935
009,omission,0.090343085816269,-566.666666666667,0.611342986231466,140,95,45,660,9,651,2.24315947400485,1.17997874847927,3.42313822248412
010,omission,0.23132639846811,733.333333333333,0.528486125493662,145,81,64,655,7,648,-0.538226899892811,2.79562733253073,2.25740043263792
011,omission,0.0700452133392549,-633.333333333333,0.43187144770616,140,119,21,660,3,657,4.32512399004087,1.11849440367795,5.44361839371883
012,omission,0.543601097110188,1066.66666666667,0.394075941127895,143,133,10,657,2,655,5.75991525740491,4.79183853798565,10.5517537953906
013,omission,0.0881365850533131,-400,0.703034835260041,139,50,89,661,22,639,-1.55332560450442,0.608077606551119,-0.945247997953305
014,omission,0.233450105642212,0,0.558223910675617,150,74,76,650,26,624,0.379454556161879,-1.31577608100483,-0.936321524842948
015,omission,0.565047739121012,1033.33333333333,0.560221432718796,140,96,44,660,11,649,3.41208108395238,2.50231478413126,5.91439586808364
016,omission,0.536508431570585,3033.33333333333,0.547473565126232,146,95,51,654,18,636,0.668158605190814,2.90734760288344,3.57550620807425
017,omission,0.472838760960556,2100,0.513609760801739,152,101,51,648,6,642,5.2442570211358,3.65485730531612,8.89911432645192
018,omission,0.281146071510181,-966.666666666667,0.593204064079946,143,100,43,657,8,649,4.5489278491308,1.64007222131081,6.18900007044161
021,omission,0.415731268112744,-966.666666666667,0.550490080520696,142,108,34,658,9,649,1.87589777795294,1.60333775883703,3.47923553678997
022,omission,0.282142490225928,2600,0.503534872456716,144,81,63,656,11,645,1.40724677071131,2.07708129074341,3.48432806145472
023,omission,0.983109220159714,966.666666666667,0.461842054403853,146,125,21,654,3,651,2.52716489250054,3.65037441890952,6.17753931141006
027,omission,0.635397271761231,866.666666666667,0.538353951290594,146,86,60,654,12,642,2.41689807176629,3.06521383642557,5.48211190819186
028,omission,0.360809588136643,1066.66666666667,0.61596213859555,144,57,87,656,32,624,1.25525053414501,2.04754902611386,3.30279956025887
029,omission,0.479764234514013,633.333333333333,0.604774614767839,146,97,49,654,16,638,-0.527234625505094,2.0514680223458,1.52423339684071
030,omission,0.0911814944495868,-966.666666666667,0.527870719360587,145,123,22,655,10,645,1.78121274730322,3.83200080256524,5.61321354986846
031,omission,0.527852087074575,1433.33333333333,0.503414875308942,143,126,17,657,12,645,5.34186579562022,0.750582435833587,6.09244823145381
032,omission,0.295970448128747,3033.33333333333,0.600984889879243,145,86,59,655,56,599,1.25350772132933,2.07211916453685,3.32562688586618
034,omission,0.467762488392587,1433.33333333333,0.509735339657009,135,78,57,665,4,661,3.5457691369595,-0.428975929219573,3.11679320773992
036,omission,0.283915942996532,-966.666666666667,0.513680463050851,140,61,79,660,25,635,2.25470375647835,2.39941217212466,4.654115928603
037,omission,0.407772484968665,1466.66666666667,0.498866799483949,141,72,69,659,7,652,0.552700892447421,-0.512575383948608,0.0401255084988126
038,omission,0.645508929431216,1400,0.522690464549907,148,107,41,652,1,651,1.23465232005157,3.15069185575071,4.38534417580228
039,omission,0.453079600960515,700,0.471121705877984,145,123,22,655,43,612,2.79471713430922,0.614659203059256,3.40937633736847
053,omission,0.513470930515519,1866.66666666667,0.509058358226163,142,84,58,658,7,651,3.23819200508812,0.393284134559916,3.63147613964803
054,omission,0.541049899368708,733.333333333333,0.431372952885004,150,138,12,650,2,648,1.25479903705381,2.05953936546884,3.31433840252266
055,omission,0.482467397447757,966.666666666667,0.497616750378051,141,124,17,659,64,595,2.63268345170178,2.93386341769574,5.56654686939752
056,omission,0.0994336174708073,-966.666666666667,0.479524329992138,141,108,33,659,11,648,0.177254073116343,0.567882167877152,0.745136240993495
057,omission,0.653310475907529,866.666666666667,0.527480709778266,141,108,33,659,13,646,3.26830194401335,2.49310803990625,5.7614099839196
058,omission,0.27674702765523,-66.6666666666667,0.577342178141628,149,99,50,651,25,626,0.137786772686558,0.279713384168982,0.41750015685554
059,omission,0.109198172222145,-966.666666666667,0.661444202696381,146,56,90,654,16,638,1.08520595596787,1.41612429307607,2.50133024904394
060,omission,0.311270870178011,933.333333333333,0.497463323371007,141,105,36,659,8,651,5.41816960694022,5.02003820493349,10.4382078118737
061,omission,0.329926375804265,-866.666666666667,0.551656813202365,147,95,52,653,18,635,3.57174239226416,1.93185862167865,5.50360101394282
063,omission,0.169365097298641,-966.666666666667,0.58730658062708,145,86,59,655,0,655,3.50880959229508,5.0150498163747,8.52385940866978
064,omission,0.225780726507509,-966.666666666667,0.480484786569529,138,90,48,662,35,627,1.03300138865522,1.70690991713356,2.73991130578878
065,omission,0.152876447323831,-533.333333333333,0.407144236291267,146,141,5,654,1,653,2.62662849924977,0.555396979347317,3.18202547859708
067,omission,0.271630577021766,-966.666666666667,0.501427399558856,143,108,35,657,5,652,4.83873283398617,5.22452352675484,10.063256360741
068,omission,0.260630207205161,1300,0.542944323352363,147,105,42,653,2,651,5.00182424579773,4.00064357246787,9.0024678182656
069,omission,0.224082685106864,-366.666666666667,0.431814958358154,148,120,28,652,33,619,5.10961578841621,0.137520300538864,5.24713608895507
070,omission,0.189918954183397,-633.333333333333,0.467651202145805,143,95,48,657,15,642,3.94955093751502,-0.854991007494328,3.09455993002069
071,omission,0.535164671551793,2366.66666666667,0.477328078542766,145,103,42,655,44,611,1.26294944433187,1.59755674261892,2.86050618695079
072,omission,0.206500274081738,1966.66666666667,0.505730320202842,140,84,56,660,22,638,1.51289280602381,-0.364188236581963,1.14870456944184
073,omission,0.260572829677691,2300,0.667411033644688,147,48,99,653,10,643,-0.0352942608444444,3.66212990686959,3.62683564602514
075,omission,0.221798361290008,-966.666666666667,0.461755115199199,142,106,36,658,40,618,0.376555534847306,3.29925792823071,3.67581346307802
077,omission,0.36341065597158,1033.33333333333,0.519643231383834,148,79,69,652,21,631,-0.213694555570801,0.406816111228503,0.193121555657703
078,omission,0.269992906006703,933.333333333333,0.510430424167391,143,85,58,657,6,651,4.49787595585635,3.27331132752669,7.77118728338303
079,omission,0.289246761625358,833.333333333333,0.462288364866569,145,127,18,655,3,652,4.58480367451024,4.60031675157833,9.18512042608857
080,omission,0.4316669521944,2866.66666666667,0.571399441315757,149,52,97,651,131,520,0.956929200713414,-0.812701174038777,0.144228026674637
081,omission,1.02277285746785,1900,0.649855303797477,146,143,3,654,11,643,1.25574535479339,1.82533206085803,3.08107741565142
082,omission,0.122477280270761,-633.333333333333,0.56671739976709,138,105,33,662,58,604,4.7145645628092,2.14130940462732,6.85587396743652
083,omission,0.361391830644124,1566.66666666667,0.475027546407391,137,106,31,663,10,653,4.54632458406348,0.611847975693186,5.15817255975667
084,omission,0.0673107828613013,-400,0.609384293736118,143,41,102,657,45,612,1.25555673241278,2.05185169244645,3.30740842485922
086,omission,0.56870776979086,566.666666666667,0.367304868124716,146,138,8,654,21,633,2.66217509850793,2.68312254886604,5.34529764737397
087,omission,0.496795865555175,0,0.280071628762862,142,142,0,658,548,110,4.44985435368166,2.20487838335925,6.65473273704091
088,omission,1.03006661239897,766.666666666667,0.337041257491211,142,142,0,658,7,651,2.61816212350328,1.86795284029657,4.48611496379985
089,omission,0.290230744037391,-966.666666666667,0.498369125310481,134,56,78,666,13,653,-0.874817872093457,0.0782681057083153,-0.796549766385141
090,omission,0.234967827226049,833.333333333333,0.614376304774649,144,63,81,656,5,651,2.60189758054638,2.68115190750947,5.28304948805584
092,omission,0.183565484789161,1033.33333333333,0.394093996752053,145,130,15,655,1,654,-0.872124112031237,-0.714973554011881,-1.58709766604312
093,omission,0.583118705639294,-966.666666666667,0.453651951893384,139,74,65,661,2,659,0.784122632232571,3.46286249028253,4.2469851225151
094,omission,0.295402065959548,-966.666666666667,0.506288494694593,144,92,52,656,12,644,0.231663632679181,5.71591709765526,5.94758073033444
095,omission,0.0807146986700491,-133.333333333333,0.574290100477058,145,87,58,655,36,619,0.653018291442756,0.625661668701192,1.27867996014395
096,omission,0.683838178593142,-966.666666666667,0.428939370092537,139,105,34,661,3,658,2.65158764173052,3.00605910605768,5.6576467477882
097,omission,0.12863282045511,-833.333333333333,0.539360222628836,150,109,41,650,6,644,4.48849362648045,1.14690974057349,5.63540336705394
100,omission,0.281160626856108,-300,0.495311823973229,143,101,42,657,21,636,3.68720567612967,-0.609993501719291,3.07721217441038
101,omission,0.98204127205646,3000,0.558976587427177,144,85,59,656,17,639,3.37816246550339,1.49778931699352,4.87595178249691
102,omission,0.253603368557848,-600,0.518015815866244,140,119,21,660,10,650,1.75225625001837,3.25080069511659,5.00305694513495
106,omission,0.262342494151728,900,0.407158206342285,147,118,29,653,265,388,1.50527987092354,0.210080204893992,1.71536007581753
001,standard,0.299819000987753,-200,0.562967899408088,138,90,48,662,3,659,5.66215580573317,0.801576508739021,6.46373231447219
002,standard,0.0725563308073936,-200,0,137,131,6,663,6,657,-1.21669075466724,5.00263161585697,3.78594086118974
003,standard,0.0832033765100888,-166.666666666667,0.58229570944992,142,122,20,658,13,645,-1.30507967787568,0.626637477028827,-0.678442200846854
005,standard,0.159000462965878,2966.66666666667,0.497179164908205,145,90,55,655,8,647,2.05285594556469,2.82904868889549,4.88190463446018
008,standard,0.0336380916253853,33.3333333333333,0.47228018535329,146,133,13,654,2,652,3.84947848209552,2.01384236510383,5.86332084719935
009,standard,0.0408505605454905,-533.333333333333,0.611342986231466,140,95,45,660,9,651,2.24315947400485,1.17997874847927,3.42313822248412
010,standard,0.0737306111408598,-300,0.528486125493662,145,81,64,655,7,648,-0.538226899892811,2.79562733253073,2.25740043263792
011,standard,0.138054724433513,1833.33333333333,0.43187144770616,140,119,21,660,3,657,4.32512399004087,1.11849440367795,5.44361839371883
012,standard,0.130890885423501,-233.333333333333,0.394075941127895,143,133,10,657,2,655,5.75991525740491,4.79183853798565,10.5517537953906
013,standard,0.0773826836983795,-966.666666666667,0.703034835260041,139,50,89,661,22,639,-1.55332560450442,0.608077606551119,-0.945247997953305
014,standard,0.0960519648611054,233.333333333333,0.558223910675617,150,74,76,650,26,624,0.379454556161879,-1.31577608100483,-0.936321524842948
015,standard,0.279083529717562,2266.66666666667,0.560221432718796,140,96,44,660,11,649,3.41208108395238,2.50231478413126,5.91439586808364
016,standard,0.115379727475898,-300,0.547473565126232,146,95,51,654,18,636,0.668158605190814,2.90734760288344,3.57550620807425
017,standard,0.206947122263227,2233.33333333333,0.513609760801739,152,101,51,648,6,642,5.2442570211358,3.65485730531612,8.89911432645192
018,standard,0.0912752881673528,-166.666666666667,0.593204064079946,143,100,43,657,8,649,4.5489278491308,1.64007222131081,6.18900007044161
021,standard,0.098523425530801,-133.333333333333,0.550490080520696,142,108,34,658,9,649,1.87589777795294,1.60333775883703,3.47923553678997
022,standard,0.0663487495203391,2566.66666666667,0.503534872456716,144,81,63,656,11,645,1.40724677071131,2.07708129074341,3.48432806145472
023,standard,0.293244008357428,2200,0.461842054403853,146,125,21,654,3,651,2.52716489250054,3.65037441890952,6.17753931141006
027,standard,0.0251850566585376,-566.666666666667,0.538353951290594,146,86,60,654,12,642,2.41689807176629,3.06521383642557,5.48211190819186
028,standard,0.043192439579954,-566.666666666667,0.61596213859555,144,57,87,656,32,624,1.25525053414501,2.04754902611386,3.30279956025887
029,standard,0.205047621374093,3033.33333333333,0.604774614767839,146,97,49,654,16,638,-0.527234625505094,2.0514680223458,1.52423339684071
030,standard,0.0216540599969139,-800,0.527870719360587,145,123,22,655,10,645,1.78121274730322,3.83200080256524,5.61321354986846
031,standard,0.232522399107916,2400,0.503414875308942,143,126,17,657,12,645,5.34186579562022,0.750582435833587,6.09244823145381
032,standard,0.0345018782900429,-233.333333333333,0.600984889879243,145,86,59,655,56,599,1.25350772132933,2.07211916453685,3.32562688586618
034,standard,0.152548564119873,2366.66666666667,0.509735339657009,135,78,57,665,4,661,3.5457691369595,-0.428975929219573,3.11679320773992
036,standard,0.0240465272005984,-366.666666666667,0.513680463050851,140,61,79,660,25,635,2.25470375647835,2.39941217212466,4.654115928603
037,standard,0.0290234269685625,2266.66666666667,0.498866799483949,141,72,69,659,7,652,0.552700892447421,-0.512575383948608,0.0401255084988126
038,standard,0.0175187767391735,-400,0.522690464549907,148,107,41,652,1,651,1.23465232005157,3.15069185575071,4.38534417580228
039,standard,0.0822558882518428,-500,0.471121705877984,145,123,22,655,43,612,2.79471713430922,0.614659203059256,3.40937633736847
053,standard,0.115239504819097,366.666666666667,0.509058358226163,142,84,58,658,7,651,3.23819200508812,0.393284134559916,3.63147613964803
054,standard,0.0972583836118558,-533.333333333333,0.431372952885004,150,138,12,650,2,648,1.25479903705381,2.05953936546884,3.31433840252266
055,standard,0.149914799744573,-100,0.497616750378051,141,124,17,659,64,595,2.63268345170178,2.93386341769574,5.56654686939752
056,standard,0.0673830179425354,-333.333333333333,0.479524329992138,141,108,33,659,11,648,0.177254073116343,0.567882167877152,0.745136240993495
057,standard,0.0752354800962695,-100,0.527480709778266,141,108,33,659,13,646,3.26830194401335,2.49310803990625,5.7614099839196
058,standard,0.319583351959401,2633.33333333333,0.577342178141628,149,99,50,651,25,626,0.137786772686558,0.279713384168982,0.41750015685554
059,standard,0.125214634501129,2300,0.661444202696381,146,56,90,654,16,638,1.08520595596787,1.41612429307607,2.50133024904394
060,standard,0.0841003506186576,66.6666666666667,0.497463323371007,141,105,36,659,8,651,5.41816960694022,5.02003820493349,10.4382078118737
061,standard,0.106912102797444,-933.333333333333,0.551656813202365,147,95,52,653,18,635,3.57174239226416,1.93185862167865,5.50360101394282
063,standard,0.108266874686314,-166.666666666667,0.58730658062708,145,86,59,655,0,655,3.50880959229508,5.0150498163747,8.52385940866978
064,standard,0.0488449332799495,-133.333333333333,0.480484786569529,138,90,48,662,35,627,1.03300138865522,1.70690991713356,2.73991130578878
065,standard,0.0787947794771491,-400,0.407144236291267,146,141,5,654,1,653,2.62662849924977,0.555396979347317,3.18202547859708
067,standard,0.0618802535957328,-566.666666666667,0.501427399558856,143,108,35,657,5,652,4.83873283398617,5.22452352675484,10.063256360741
068,standard,0.1516705104734,66.6666666666667,0.542944323352363,147,105,42,653,2,651,5.00182424579773,4.00064357246787,9.0024678182656
069,standard,0.149346373705597,700,0.431814958358154,148,120,28,652,33,619,5.10961578841621,0.137520300538864,5.24713608895507
070,standard,0.106500021905844,0,0.467651202145805,143,95,48,657,15,642,3.94955093751502,-0.854991007494328,3.09455993002069
071,standard,0.116402562562765,0,0.477328078542766,145,103,42,655,44,611,1.26294944433187,1.59755674261892,2.86050618695079
072,standard,0.0728532024514068,-666.666666666667,0.505730320202842,140,84,56,660,22,638,1.51289280602381,-0.364188236581963,1.14870456944184
073,standard,0.135224221703064,-233.333333333333,0.667411033644688,147,48,99,653,10,643,-0.0352942608444444,3.66212990686959,3.62683564602514
075,standard,0.0936330193749081,2100,0.461755115199199,142,106,36,658,40,618,0.376555534847306,3.29925792823071,3.67581346307802
077,standard,0.112214341924597,2166.66666666667,0.519643231383834,148,79,69,652,21,631,-0.213694555570801,0.406816111228503,0.193121555657703
078,standard,0.15049783109134,-533.333333333333,0.510430424167391,143,85,58,657,6,651,4.49787595585635,3.27331132752669,7.77118728338303
079,standard,0.0867897577675764,-433.333333333333,0.462288364866569,145,127,18,655,3,652,4.58480367451024,4.60031675157833,9.18512042608857
080,standard,0.0448093645701648,-733.333333333333,0.571399441315757,149,52,97,651,131,520,0.956929200713414,-0.812701174038777,0.144228026674637
081,standard,0.476697255766385,2933.33333333333,0.649855303797477,146,143,3,654,11,643,1.25574535479339,1.82533206085803,3.08107741565142
082,standard,0.0908781880103517,-433.333333333333,0.56671739976709,138,105,33,662,58,604,4.7145645628092,2.14130940462732,6.85587396743652
083,standard,0.234259319380144,2700,0.475027546407391,137,106,31,663,10,653,4.54632458406348,0.611847975693186,5.15817255975667
084,standard,0.0581227105863906,-966.666666666667,0.609384293736118,143,41,102,657,45,612,1.25555673241278,2.05185169244645,3.30740842485922
086,standard,0.0585668606282823,-566.666666666667,0.367304868124716,146,138,8,654,21,633,2.66217509850793,2.68312254886604,5.34529764737397
087,standard,0.173303169473252,2033.33333333333,0.280071628762862,142,142,0,658,548,110,4.44985435368166,2.20487838335925,6.65473273704091
088,standard,0.115468752266473,2466.66666666667,0.337041257491211,142,142,0,658,7,651,2.61816212350328,1.86795284029657,4.48611496379985
089,standard,0.124044415127435,200,0.498369125310481,134,56,78,666,13,653,-0.874817872093457,0.0782681057083153,-0.796549766385141
090,standard,0.0962676909972072,-333.333333333333,0.614376304774649,144,63,81,656,5,651,2.60189758054638,2.68115190750947,5.28304948805584
092,standard,0.0324766982507745,-233.333333333333,0.394093996752053,145,130,15,655,1,654,-0.872124112031237,-0.714973554011881,-1.58709766604312
093,standard,0.0626316736019615,-100,0.453651951893384,139,74,65,661,2,659,0.784122632232571,3.46286249028253,4.2469851225151
094,standard,0.0363401743235468,-533.333333333333,0.506288494694593,144,92,52,656,12,644,0.231663632679181,5.71591709765526,5.94758073033444
095,standard,0.0661544627933209,-566.666666666667,0.574290100477058,145,87,58,655,36,619,0.653018291442756,0.625661668701192,1.27867996014395
096,standard,0.0360377098656313,-566.666666666667,0.428939370092537,139,105,34,661,3,658,2.65158764173052,3.00605910605768,5.6576467477882
097,standard,0.050411010911879,-100,0.539360222628836,150,109,41,650,6,644,4.48849362648045,1.14690974057349,5.63540336705394
100,standard,0.175153007848336,2200,0.495311823973229,143,101,42,657,21,636,3.68720567612967,-0.609993501719291,3.07721217441038
101,standard,0.118017589434242,633.333333333333,0.558976587427177,144,85,59,656,17,639,3.37816246550339,1.49778931699352,4.87595178249691
102,standard,0.137132494593892,2866.66666666667,0.518015815866244,140,119,21,660,10,650,1.75225625001837,3.25080069511659,5.00305694513495
106,standard,0.0764366251909251,-366.666666666667,0.407158206342285,147,118,29,653,265,388,1.50527987092354,0.210080204893992,1.71536007581753
001,novel,0.38184901230368,2233.33333333333,0.562967899408088,138,90,48,662,3,659,5.66215580573317,0.801576508739021,6.46373231447219
002,novel,0.188087584151531,1566.66666666667,0,137,131,6,663,6,657,-1.21669075466724,5.00263161585697,3.78594086118974
003,novel,0.503027339522083,633.333333333333,0.58229570944992,142,122,20,658,13,645,-1.30507967787568,0.626637477028827,-0.678442200846854
005,novel,0.430906737998871,2933.33333333333,0.497179164908205,145,90,55,655,8,647,2.05285594556469,2.82904868889549,4.88190463446018
008,novel,0.368957648680379,1233.33333333333,0.47228018535329,146,133,13,654,2,652,3.84947848209552,2.01384236510383,5.86332084719935
009,novel,0.281351214118256,1433.33333333333,0.611342986231466,140,95,45,660,9,651,2.24315947400485,1.17997874847927,3.42313822248412
010,novel,0.245142214544176,933.333333333333,0.528486125493662,145,81,64,655,7,648,-0.538226899892811,2.79562733253073,2.25740043263792
011,novel,0.155672953140514,600,0.43187144770616,140,119,21,660,3,657,4.32512399004087,1.11849440367795,5.44361839371883
012,novel,0.388751297736579,2033.33333333333,0.394075941127895,143,133,10,657,2,655,5.75991525740491,4.79183853798565,10.5517537953906
013,novel,0.338321988919513,1433.33333333333,0.703034835260041,139,50,89,661,22,639,-1.55332560450442,0.608077606551119,-0.945247997953305
014,novel,0.389856388017731,1500,0.558223910675617,150,74,76,650,26,624,0.379454556161879,-1.31577608100483,-0.936321524842948
015,novel,0.438039185782597,966.666666666667,0.560221432718796,140,96,44,660,11,649,3.41208108395238,2.50231478413126,5.91439586808364
016,novel,0.26168707573398,666.666666666667,0.547473565126232,146,95,51,654,18,636,0.668158605190814,2.90734760288344,3.57550620807425
017,novel,0.480597606956418,733.333333333333,0.513609760801739,152,101,51,648,6,642,5.2442570211358,3.65485730531612,8.89911432645192
018,novel,0.358344138108228,1000,0.593204064079946,143,100,43,657,8,649,4.5489278491308,1.64007222131081,6.18900007044161
021,novel,0.315253269805472,766.666666666667,0.550490080520696,142,108,34,658,9,649,1.87589777795294,1.60333775883703,3.47923553678997
022,novel,0.457851089671341,1000,0.503534872456716,144,81,63,656,11,645,1.40724677071131,2.07708129074341,3.48432806145472
023,novel,0.216081135551825,2300,0.461842054403853,146,125,21,654,3,651,2.52716489250054,3.65037441890952,6.17753931141006
027,novel,0.427221473727026,1433.33333333333,0.538353951290594,146,86,60,654,12,642,2.41689807176629,3.06521383642557,5.48211190819186
028,novel,0.0702836795710611,900,0.61596213859555,144,57,87,656,32,624,1.25525053414501,2.04754902611386,3.30279956025887
029,novel,0.410696460130876,1200,0.604774614767839,146,97,49,654,16,638,-0.527234625505094,2.0514680223458,1.52423339684071
030,novel,0.276169594767322,1333.33333333333,0.527870719360587,145,123,22,655,10,645,1.78121274730322,3.83200080256524,5.61321354986846
031,novel,0.198507032230468,-833.333333333333,0.503414875308942,143,126,17,657,12,645,5.34186579562022,0.750582435833587,6.09244823145381
032,novel,0.112328536988512,1166.66666666667,0.600984889879243,145,86,59,655,56,599,1.25350772132933,2.07211916453685,3.32562688586618
034,novel,0.390260829023955,2566.66666666667,0.509735339657009,135,78,57,665,4,661,3.5457691369595,-0.428975929219573,3.11679320773992
036,novel,0.283215898966537,1333.33333333333,0.513680463050851,140,61,79,660,25,635,2.25470375647835,2.39941217212466,4.654115928603
037,novel,0.442943491690107,1233.33333333333,0.498866799483949,141,72,69,659,7,652,0.552700892447421,-0.512575383948608,0.0401255084988126
038,novel,0.19872215268224,2533.33333333333,0.522690464549907,148,107,41,652,1,651,1.23465232005157,3.15069185575071,4.38534417580228
039,novel,0.195873551388792,700,0.471121705877984,145,123,22,655,43,612,2.79471713430922,0.614659203059256,3.40937633736847
053,novel,0.791633416242033,1533.33333333333,0.509058358226163,142,84,58,658,7,651,3.23819200508812,0.393284134559916,3.63147613964803
054,novel,0.172152060207047,700,0.431372952885004,150,138,12,650,2,648,1.25479903705381,2.05953936546884,3.31433840252266
055,novel,0.502367073118384,966.666666666667,0.497616750378051,141,124,17,659,64,595,2.63268345170178,2.93386341769574,5.56654686939752
056,novel,0.114276611865956,700,0.479524329992138,141,108,33,659,11,648,0.177254073116343,0.567882167877152,0.745136240993495
057,novel,0.262377743539639,666.666666666667,0.527480709778266,141,108,33,659,13,646,3.26830194401335,2.49310803990625,5.7614099839196
058,novel,0.398887276705716,700,0.577342178141628,149,99,50,651,25,626,0.137786772686558,0.279713384168982,0.41750015685554
059,novel,0.606504770516888,3033.33333333333,0.661444202696381,146,56,90,654,16,638,1.08520595596787,1.41612429307607,2.50133024904394
060,novel,0.454977943895205,766.666666666667,0.497463323371007,141,105,36,659,8,651,5.41816960694022,5.02003820493349,10.4382078118737
061,novel,0.161573663746744,-966.666666666667,0.551656813202365,147,95,52,653,18,635,3.57174239226416,1.93185862167865,5.50360101394282
063,novel,0.107733602887819,3033.33333333333,0.58730658062708,145,86,59,655,0,655,3.50880959229508,5.0150498163747,8.52385940866978
064,novel,0.211009277315355,3033.33333333333,0.480484786569529,138,90,48,662,35,627,1.03300138865522,1.70690991713356,2.73991130578878
065,novel,0.268696816832205,3033.33333333333,0.407144236291267,146,141,5,654,1,653,2.62662849924977,0.555396979347317,3.18202547859708
067,novel,0.269545658789028,966.666666666667,0.501427399558856,143,108,35,657,5,652,4.83873283398617,5.22452352675484,10.063256360741
068,novel,0.402530944902014,1233.33333333333,0.542944323352363,147,105,42,653,2,651,5.00182424579773,4.00064357246787,9.0024678182656
069,novel,0.0660892384517738,-333.333333333333,0.431814958358154,148,120,28,652,33,619,5.10961578841621,0.137520300538864,5.24713608895507
070,novel,0.488079672078961,1500,0.467651202145805,143,95,48,657,15,642,3.94955093751502,-0.854991007494328,3.09455993002069
071,novel,0.445024251242457,1166.66666666667,0.477328078542766,145,103,42,655,44,611,1.26294944433187,1.59755674261892,2.86050618695079
072,novel,0.190709775421325,-133.333333333333,0.505730320202842,140,84,56,660,22,638,1.51289280602381,-0.364188236581963,1.14870456944184
073,novel,0.367160787260659,900,0.667411033644688,147,48,99,653,10,643,-0.0352942608444444,3.66212990686959,3.62683564602514
075,novel,0.127222607234991,700,0.461755115199199,142,106,36,658,40,618,0.376555534847306,3.29925792823071,3.67581346307802
077,novel,0.241097856308631,700,0.519643231383834,148,79,69,652,21,631,-0.213694555570801,0.406816111228503,0.193121555657703
078,novel,0.230234356634209,633.333333333333,0.510430424167391,143,85,58,657,6,651,4.49787595585635,3.27331132752669,7.77118728338303
079,novel,0.493997702719362,1200,0.462288364866569,145,127,18,655,3,652,4.58480367451024,4.60031675157833,9.18512042608857
080,novel,0.351870978105192,733.333333333333,0.571399441315757,149,52,97,651,131,520,0.956929200713414,-0.812701174038777,0.144228026674637
081,novel,0.445896169321076,1400,0.649855303797477,146,143,3,654,11,643,1.25574535479339,1.82533206085803,3.08107741565142
082,novel,0.382670286630569,666.666666666667,0.56671739976709,138,105,33,662,58,604,4.7145645628092,2.14130940462732,6.85587396743652
083,novel,0.207844700026328,-966.666666666667,0.475027546407391,137,106,31,663,10,653,4.54632458406348,0.611847975693186,5.15817255975667
084,novel,0.156088481569638,-966.666666666667,0.609384293736118,143,41,102,657,45,612,1.25555673241278,2.05185169244645,3.30740842485922
086,novel,0.149727523875285,-633.333333333333,0.367304868124716,146,138,8,654,21,633,2.66217509850793,2.68312254886604,5.34529764737397
087,novel,0.507428159461451,2133.33333333333,0.280071628762862,142,142,0,658,548,110,4.44985435368166,2.20487838335925,6.65473273704091
088,novel,0.657288452742022,1533.33333333333,0.337041257491211,142,142,0,658,7,651,2.61816212350328,1.86795284029657,4.48611496379985
089,novel,0.356162491087661,1700,0.498369125310481,134,56,78,666,13,653,-0.874817872093457,0.0782681057083153,-0.796549766385141
090,novel,0.218418724121808,733.333333333333,0.614376304774649,144,63,81,656,5,651,2.60189758054638,2.68115190750947,5.28304948805584
092,novel,0.172463292770873,2433.33333333333,0.394093996752053,145,130,15,655,1,654,-0.872124112031237,-0.714973554011881,-1.58709766604312
093,novel,0.116631614184559,-633.333333333333,0.453651951893384,139,74,65,661,2,659,0.784122632232571,3.46286249028253,4.2469851225151
094,novel,0.264774905083853,600,0.506288494694593,144,92,52,656,12,644,0.231663632679181,5.71591709765526,5.94758073033444
095,novel,0.132730184945434,1366.66666666667,0.574290100477058,145,87,58,655,36,619,0.653018291442756,0.625661668701192,1.27867996014395
096,novel,0.240410491112087,-900,0.428939370092537,139,105,34,661,3,658,2.65158764173052,3.00605910605768,5.6576467477882
097,novel,0.481892489799511,1166.66666666667,0.539360222628836,150,109,41,650,6,644,4.48849362648045,1.14690974057349,5.63540336705394
100,novel,0.232993747989359,966.666666666667,0.495311823973229,143,101,42,657,21,636,3.68720567612967,-0.609993501719291,3.07721217441038
101,novel,0.596597920927928,1800,0.558976587427177,144,85,59,656,17,639,3.37816246550339,1.49778931699352,4.87595178249691
102,novel,0.160183533327522,2966.66666666667,0.518015815866244,140,119,21,660,10,650,1.75225625001837,3.25080069511659,5.00305694513495
106,novel,0.165869136740178,666.666666666667,0.407158206342285,147,118,29,653,265,388,1.50527987092354,0.210080204893992,1.71536007581753
